WE                            ./assets/eagle.png
NO      ./assets/eagle.png


SO ./assets/eagle.png

F      17,38,64




C 218,234,255
EA ./assets/eagle.png
11111
1E0D01
11111