F 220,070,55
C 225,230,99
NO ./assets/eagle.png
EA ./assets/wood.png
SO ./assets/redbrick.png
WE ./assets/purplestone.png


11111111111111111111111111
10000000000000000000000001
10000000000000000000000001
10011111111111111111100001
1001000000D0000000N0D00001
100111111111111D1111100001
10000000000000000000000001
11111111111111111111111111
