F 0,0,0
C 225,    030,      99
NO       ./assets/eagle.png
           EA ./assets/wood.png
SO ./assets/redbrick.png
WE ./assets/purplestone.png


11111111111111111111111111
10000000000000000000000001
10000000000000000000000001
100111111D1111111111100001
1001DD000000000000N0D00001
100111111111111D1111100001
10000000000000000000000001
11111111111111111111111111
