F 220,070,55
C 225,230,99
NO ./assets/eagle.png
EA ./assets/wood.png
SO ./assets/redbrick.png
WE ./assets/pillar.png


1111111111111111111
1000000010001000001
1000000001010100001
100000S000000000001
1000000000000000001
1111111111111111111
