F 220,070,55
C 225,230,99
NO ./assets/eagle.png
EA ./assets/wood.png
SO ./assets/redbrick.png
WE ./assets/pillar.png

111111111111111111111111111111111111111
100000000000000000000000000000000000011
100011111111111111111000011111111111011
1000100000000000000010S0010000000001011
100010001111100011001000010001111001011
100010001000100010001000010001001001011
100010001111100010001000011111001001011
100010000000000010000000000000001001011
101111111111111110011111111111111111011
100000000000000000010000000000000000011
111100001111110001110001111111111100011
100100001000010001000000000000000100011
100100001000011111000011111110001100011
100100001000000000000010000010000100011
100100001111111111000010001110001100011
100100000000000001000010000000000100011
111111111011111111000011111111111111011
100000001000000001000000000000000000011
100000001111111001111111111111111000011
111111001000000000000000000000001111111
100000001000011111111111111111111000001
100000001000010000000000000000001000001
111111111000010000000000000000001000001
100000000000011111111111111100001000001
100000000000000000000000000100001000001
111111111111111111111111111111111111111
