F 220,070,55
C 225,230,99
NO ./assets/eagle.png
EA ./assets/wood.png
SO ./assets/redbrick.png
WE ./assets/purplestone.png


111111111111111111111111111111111111111
100000000000000000000000000000000000001
100000000000000000000000000000000000001
100000000011111011111000000000000000001
100000000000000000N00000000000000000001
100000000011111011111000000000000000001
100000000000000000000000000000000000001
111111111111111111111111111111111111111
