F 220,0,55
C 225,200,99
NO ./path_to_the_north_texture
EA ./path_to_the_east_texture
SO ./path_to_the_south_texture
WE ./path_to_the_west_texture



111111111111111111111111111111111111111 
100000000000000000001110000000000000001
100000001000000000000000000000000000011
100000000000000000000000000000000000001
101110000000010000000100000000000000001
100000001000000000000000000000000000011
100000000000000000000000000000000000001
100000000000100000000000000000000000001
100000001000000000000000000000000000011
100000000000000000000000000000000000001
10000000000010000000000000000N000000001
100000001000000000000000000000000000011
100000000000000000000000000000000000001
100000000000100000000000000000000000001
100000001000000000000000000000000000011
100000000000000000000000000000000000001
100000000000100000000000001111100000001
100000001000000000000000000000100000001
100000000000000000000000001111100000001
100000000000000000000000000000000000001
111111111111111111111111111111111111111