C 225,30,,,,,
F 220,100,0  
NO ./path_to_the_north_texture
EA ./path_to_the_east_texture
SO ./path_to_the_south_texture
WE ./path_to_the_west_texture

111111111111111111111111111111111111111
110000000000100000000000000000000000001
100000001000000000000000000000000000011
100000000000000000000000000000000000001
100000000000100000000000000000000000001
10000000W000000000000000000000000000011
100000000000000000000000000000000000001
100000000000100000000000000000000000001
100000001000000000000000000000000000011
100000000000000000000000000000000000001
100000000000100000000000000000000000001
100000001000000000000000000000000000011
100000000000000000000000000000000000001
100000000000100000000000000000000000001
100000001000000000000000000000000000011
100000000000000000000000000000000000001
100000000000100000000000000000000000001
100000001000000000000000000000000000011
100000000000000000000000000000000000001
100000000000000000000000000000000000001
111111111111111111111111111111111111111