NO ./path_to_the_north_texture
EA ./path_to_the_east_texture
C 225,30,0
SO ./path_to_the_south_texture
F 220,100,0  
WE ./path_to_the_west_texture

11111111111111111111111111111111111111111111111111111111111111
1N000000000010000000000000000000000000000000000000000000000001
10000000100000000000000000000000000000000000000000000000000011
10000000000000000000000000000000000000000000000000000000000001
10000000000010000000000000000000000000000000000000000000000001
10000000100000000000000000000000000000000000000000000000000011
10000000000000000000000000000000000000000000000000000000000001
10000000000010000000000000000000000000000000000000000000000001
10000000100000000000000000000000000000000000000000000000000011
10000000000000000000000000000000000000000000000000000000000001
10000000000010000000000000000000000000000000000000000000000001
10000000100000000000000000000000000000000000000000000000000011
10000000000000000000000000000000000000000000000000000000000001
10000000000010000000000000000000000000000000000000000000000001
10000000100000000000000000000000000000000000000000000000000011
10000000000000000000000000000000000000000000000000000000000001
10000000000010000000000000000000000000000000000000000000000001
10000000100000000000000000000000000000000000000000000000000011
10000000000000000000000000000000000000000000000000000000000001
10000000000000000000000000000000000000000000000000000000000001
11111111111111111111111111111111111111111111111111111111111111