NO ./path_to_the_north_texture
EA ./path_to_the_east_texture
C 225,30,0
SO ./path_to_the_south_texture
F 220,100,0  
WE ./path_to_the_west_texture
1111111111111111111
1000000000001000001
1000000010000000011
1000000000000000001
1000000N00000000001
1111111111111111111