F 220,070,55
C 225,230,99
NO ./path_to_the_north_texture
EA ./path_to_the_east_texture
SO ./path_to_the_south_texture
WE ./path_to_the_west_texture


1111111111111111111
1000000000001000001
1000000000010100001
100000S000000000001
1000000000000000001
1111111111111111111
