C 225,30,,,,,
F 220,100,0  
NO ./path_to_the_north_texture
EA ./path_to_the_east_texture
SO ./path_to_the_south_texture
WE ./path_to_the_west_texture

111111111111111111111111
100000000000000000000001
100000000000000000000001
100000111111111111000001
100000100000000001000001
100000100000N00001000001
100000100000000001000001
100000100000000001000001
100000111000011111000001
100000001000000000000001
100000001000000000000001
100000001000000000000001
100000001000000111111111
100000001000000100000001
100000001111111100000001
100000000000000000000001
100000000000000000000001
111111111111111111111111