C 225,30,,,,,
F 220,100,0  
NO ./path_to_the_north_texture
EA ./path_to_the_east_texture
SO ./path_to_the_south_texture
WE ./path_to_the_west_texture

11111111111111111111111111111111111
10000000000000000011000000001100001
10000000000000000000000000000000001
10000000000000000000000000000000001
10000000000000000000000000000000001
100000000S0000000000000000000000001
10000000000000000000000000000000001
10000000000000000000000000000000001
10000000000000000000000000000000001
10000000000000000000000000000000001
10000000000000000000000000000000001
10000000000000000000000000000000001
10000000000000000000000000000000001
11111111111111111111111111111111111